{
	"name": "Stereo Madness",
	"music": "StereoMadness.mp3",
	"difficulty": 1,
	"colour": [0, 0, 128],
	"level": [
		["00", "00", "00", "00", "00", "00", "00", "00", "00", "00", "00", "00", "00", "00", "00", "00", "00", "00", "00", "00", "00", "00", "00", "00", "00", "00", "00", "00", "00", "00", "00", "00", "00", "00", "00", "00", "00", "00", "00", "00", "00", "00", "00", "00", "00", "00", "00", "00", "00", "00", "00", "00", "00", "00", "00", "00", "00", "00", "00", "00", "00", "00", "00", "00", "00", "00", "00", "00", "00", "00", "00", "00", "00", "00", "00", "00", "00", "00", "00", "00", "00", "00", "00", "00", "00", "00", "00", "00", "00", "00", "00", "00", "00", "00", "00", "00", "00", "00", "00", "00", "00", "00", "00", "00", "00", "00", "00", "00", "00", "00", "00", "00", "00", "00", "00", "00", "00", "00", "00", "00", "00", "00", "00", "00", "00", "00", "00", "00", "00", "00", "00", "00", "00", "00", "00", "00", "00", "00", "00", "00", "00", "00", "00", "00", "00", "00", "00", "00", "00", "00", "00", "00", "00", "00", "00", "00", "00", "00", "00", "00", "00", "00", "00", "00", "00", "00", "00", "00", "00", "00", "00", "00", "00", "00", "00", "00", "00", "00", "00", "00", "00", "00", "00", "00", "00", "00", "00", "00", "00", "00", "00", "00", "00", "00", "00", "00", "00", "00", "00", "00", "00", "00", "00", "00", "00", "00", "00", "00", "00", "00", "00", "00", "00", "00", "00", "00", "00", "00", "00", "00", "00", "00", "00", "00", "00", "00", "00", "00", "00", "00", "00", "00", "00", "00", "00", "00", "00", "00", "00", "00", "00", "00", "00", "00", "00", "00"],
		["00", "00", "00", "00", "00", "00", "00", "00", "00", "00", "00", "00", "00", "00", "00", "00", "00", "00", "00", "00", "00", "00", "00", "00", "00", "00", "00", "00", "00", "00", "00", "00", "00", "00", "00", "00", "00", "00", "00", "00", "00", "00", "00", "00", "00", "00", "00", "00", "00", "00", "00", "00", "00", "00", "00", "00", "00", "00", "00", "00", "00", "00", "00", "00", "00", "00", "00", "00", "00", "00", "00", "00", "00", "00", "00", "00", "00", "00", "00", "00", "00", "00", "00", "00", "00", "00", "00", "00", "00", "00", "00", "00", "00", "00", "00", "00", "00", "00", "00", "00", "00", "00", "00", "00", "00", "00", "00", "00", "00", "00", "00", "00", "00", "00", "00", "00", "00", "00", "00", "00", "00", "00", "00", "00", "00", "00", "00", "00", "00", "00", "00", "00", "00", "00", "00", "00", "00", "00", "00", "00", "00", "00", "00", "00", "00", "00", "00", "00", "00", "00", "00", "00", "00", "00", "00", "00", "00", "00", "00", "00", "00", "00", "00", "00", "00", "00", "00", "00", "00", "00", "00", "00", "00", "00", "00", "00", "00", "00", "00", "00", "00", "00", "00", "00", "00", "00", "00", "00", "00", "00", "00", "00", "00", "00", "00", "00", "00", "00", "00", "00", "00", "00", "00", "00", "00", "00", "00", "00", "00", "00", "00", "00", "00", "00", "00", "00", "00", "00", "00", "00", "00", "00", "00", "00", "00", "00", "00", "00", "00", "00", "00", "00", "00", "00", "00", "00", "00", "00", "00", "00", "00", "S1", "00", "00", "00", "00"],
		["00", "00", "00", "00", "00", "00", "00", "00", "00", "00", "00", "00", "00", "00", "00", "00", "00", "00", "00", "00", "00", "00", "00", "00", "00", "00", "00", "00", "00", "00", "00", "00", "00", "00", "00", "00", "00", "00", "00", "00", "00", "00", "00", "00", "00", "00", "00", "00", "00", "00", "00", "00", "00", "00", "00", "00", "00", "00", "00", "00", "00", "00", "00", "00", "00", "00", "00", "00", "00", "00", "00", "00", "00", "00", "00", "00", "00", "00", "00", "00", "00", "00", "00", "00", "00", "00", "00", "00", "00", "00", "00", "00", "00", "00", "00", "00", "00", "00", "00", "00", "00", "00", "00", "00", "00", "00", "00", "00", "00", "00", "00", "00", "00", "00", "00", "00", "00", "00", "00", "00", "00", "00", "00", "00", "00", "00", "00", "00", "00", "00", "00", "00", "00", "00", "00", "00", "00", "00", "00", "00", "00", "00", "00", "00", "00", "00", "00", "00", "00", "00", "00", "00", "00", "00", "00", "00", "00", "00", "b1", "b1", "00", "00", "00", "00", "00", "00", "b1", "b1", "00", "00", "00", "00", "00", "00", "00", "00", "S1", "S1", "S1", "S1", "00", "00", "00", "00", "00", "00", "00", "00", "00", "00", "00", "00", "00", "00", "00", "00", "00", "00", "00", "00", "00", "00", "00", "00", "00", "00", "00", "00", "00", "00", "00", "00", "00", "00", "00", "00", "00", "00", "00", "00", "00", "00", "00", "00", "00", "00", "00", "00", "00", "00", "00", "00", "00", "00", "00", "00", "00", "00", "00", "00", "00", "b1", "00", "00", "00", "00"],
		["00", "00", "00", "00", "00", "00", "00", "00", "00", "00", "00", "00", "00", "00", "00", "00", "00", "00", "00", "00", "00", "00", "00", "00", "00", "00", "00", "00", "00", "00", "00", "00", "00", "00", "00", "00", "00", "00", "00", "00", "00", "00", "00", "00", "00", "00", "00", "00", "00", "00", "00", "00", "00", "00", "00", "00", "00", "00", "00", "00", "00", "00", "00", "00", "00", "00", "00", "00", "00", "00", "00", "00", "00", "00", "00", "00", "00", "00", "00", "00", "00", "00", "00", "00", "00", "00", "00", "00", "00", "00", "00", "00", "00", "00", "00", "00", "00", "00", "00", "00", "00", "00", "00", "00", "00", "00", "00", "00", "00", "00", "00", "00", "00", "00", "00", "00", "00", "00", "00", "00", "00", "00", "00", "00", "00", "00", "00", "00", "00", "00", "00", "00", "00", "00", "00", "00", "00", "00", "00", "00", "00", "00", "00", "00", "00", "00", "00", "b1", "00", "00", "00", "00", "00", "00", "00", "00", "00", "S1", "S1", "S1", "S1", "00", "00", "00", "00", "S1", "S1", "S1", "S1", "00", "00", "00", "00", "00", "00", "00", "b1", "b1", "b1", "b1", "00", "00", "00", "00", "00", "00", "00", "S1", "00", "00", "00", "00", "00", "00", "00", "00", "00", "00", "00", "00", "00", "00", "00", "00", "00", "00", "00", "00", "00", "00", "00", "00", "00", "00", "00", "00", "00", "00", "00", "00", "00", "00", "00", "00", "00", "00", "00", "00", "00", "00", "00", "00", "00", "00", "00", "00", "00", "b1", "00", "00", "00", "00", "00", "00", "00", "00"],
		["00", "00", "00", "00", "00", "00", "00", "00", "00", "00", "00", "00", "00", "00", "00", "00", "00", "00", "00", "00", "00", "00", "00", "00", "00", "00", "00", "00", "00", "00", "00", "00", "00", "00", "00", "00", "00", "00", "00", "00", "00", "00", "00", "00", "00", "00", "00", "00", "00", "00", "00", "00", "00", "00", "00", "00", "00", "00", "00", "00", "00", "00", "00", "00", "00", "00", "00", "00", "00", "00", "00", "00", "00", "00", "00", "00", "00", "00", "00", "00", "00", "00", "00", "00", "00", "00", "00", "00", "00", "00", "00", "00", "00", "00", "00", "00", "00", "00", "00", "00", "00", "00", "00", "00", "00", "00", "00", "00", "00", "00", "00", "00", "00", "00", "00", "00", "00", "00", "00", "00", "00", "00", "00", "00", "00", "00", "00", "00", "00", "00", "00", "00", "00", "00", "00", "00", "00", "00", "00", "00", "00", "00", "00", "b1", "00", "00", "00", "00", "00", "00", "00", "B1", "B1", "B1", "B1", "B1", "B1", "B1", "B1", "B1", "B1", "B1", "B1", "B1", "B1", "B1", "B1", "B1", "B1", "B1", "B1", "B1", "B1", "00", "00", "00", "00", "00", "00", "00", "00", "00", "00", "B1", "B1", "B1", "B1", "B1", "00", "00", "00", "00", "00", "00", "00", "00", "00", "00", "00", "00", "00", "00", "00", "00", "00", "00", "00", "00", "00", "00", "00", "00", "00", "00", "00", "00", "00", "00", "00", "00", "00", "00", "00", "00", "00", "00", "00", "00", "00", "00", "00", "00", "00", "b1", "00", "00", "00", "00", "00", "00", "00", "00", "00", "00", "00", "00"],
		["00", "00", "00", "00", "00", "00", "00", "00", "00", "00", "00", "00", "00", "00", "00", "00", "00", "00", "00", "00", "00", "00", "00", "00", "00", "00", "00", "00", "00", "00", "00", "00", "00", "00", "00", "00", "00", "00", "00", "00", "00", "00", "00", "00", "00", "00", "00", "00", "00", "00", "00", "00", "00", "00", "00", "00", "00", "00", "00", "00", "00", "00", "00", "00", "00", "00", "00", "00", "00", "00", "00", "00", "00", "00", "00", "00", "00", "00", "00", "00", "00", "00", "00", "00", "00", "00", "00", "00", "00", "00", "00", "00", "00", "00", "00", "00", "00", "00", "00", "00", "00", "00", "00", "00", "00", "00", "00", "00", "00", "00", "00", "00", "00", "00", "00", "00", "00", "00", "00", "00", "00", "00", "00", "00", "00", "00", "00", "00", "00", "00", "00", "00", "00", "00", "00", "00", "00", "00", "00", "b1", "00", "00", "00", "00", "00", "00", "00", "00", "00", "00", "00", "00", "00", "B1", "B1", "B1", "B1", "B1", "B1", "B1", "B1", "B1", "B1", "B1", "B1", "B1", "B1", "B1", "B1", "B1", "B1", "B1", "B1", "B1", "B1", "B1", "B1", "B1", "B1", "B1", "B1", "B1", "B1", "B1", "B1", "B1", "B1", "B1", "S1", "00", "00", "00", "00", "00", "00", "00", "00", "00", "00", "00", "00", "00", "00", "S1", "00", "00", "00", "00", "00", "00", "00", "00", "00", "00", "00", "00", "00", "00", "00", "00", "00", "00", "00", "00", "00", "00", "00", "00", "00", "b1", "00", "00", "00", "00", "00", "00", "00", "00", "00", "00", "00", "00", "00", "00", "00", "00"],
		["00", "00", "00", "00", "00", "00", "00", "00", "00", "00", "00", "00", "00", "00", "00", "00", "00", "00", "00", "00", "00", "00", "00", "00", "00", "00", "00", "00", "00", "00", "00", "00", "00", "00", "00", "00", "00", "00", "00", "00", "00", "00", "00", "00", "00", "00", "00", "00", "00", "00", "00", "00", "00", "00", "00", "00", "00", "00", "00", "00", "00", "00", "00", "00", "00", "00", "00", "00", "00", "00", "00", "00", "00", "00", "00", "00", "00", "00", "00", "00", "00", "00", "00", "00", "00", "00", "00", "00", "00", "00", "00", "00", "00", "00", "00", "00", "00", "00", "00", "00", "00", "00", "00", "00", "00", "00", "00", "00", "00", "00", "00", "00", "00", "00", "00", "00", "00", "00", "00", "00", "00", "00", "00", "00", "00", "00", "00", "00", "00", "00", "00", "00", "00", "00", "00", "b1", "00", "00", "00", "00", "00", "00", "00", "00", "00", "00", "00", "00", "00", "00", "00", "00", "00", "B1", "B1", "B1", "B1", "B1", "B1", "B1", "B1", "B1", "B1", "B1", "B1", "B1", "B1", "B1", "B1", "B1", "B1", "B1", "B1", "B1", "B1", "B1", "B1", "B1", "B1", "B1", "B1", "B1", "B1", "B1", "B1", "B1", "B1", "B1", "B1", "B1", "B1", "B1", "B1", "B1", "B1", "B1", "B1", "B1", "00", "00", "b1", "b1", "b1", "b1", "00", "00", "00", "00", "00", "00", "00", "S1", "00", "00", "00", "00", "00", "00", "00", "00", "00", "00", "00", "00", "00", "b1", "00", "00", "00", "00", "00", "00", "00", "00", "00", "00", "00", "00", "00", "B1", "B1", "B1", "B1", "B1", "B1", "B1"],
		["00", "00", "00", "00", "00", "00", "00", "00", "00", "00", "00", "00", "00", "00", "00", "00", "00", "00", "00", "00", "00", "00", "00", "00", "00", "00", "00", "00", "00", "00", "00", "00", "00", "00", "00", "00", "00", "00", "00", "00", "00", "00", "00", "00", "00", "00", "00", "00", "00", "00", "00", "00", "00", "00", "00", "00", "00", "00", "00", "00", "00", "00", "B1", "00", "00", "00", "00", "00", "00", "00", "00", "00", "00", "00", "00", "00", "00", "00", "00", "00", "00", "00", "00", "00", "00", "00", "00", "00", "00", "00", "00", "00", "00", "00", "00", "00", "00", "00", "00", "00", "00", "00", "00", "00", "00", "00", "00", "00", "00", "00", "00", "00", "00", "00", "00", "00", "00", "00", "00", "00", "00", "S1", "00", "00", "00", "00", "00", "00", "00", "00", "00", "b1", "00", "00", "00", "00", "00", "00", "00", "00", "00", "00", "00", "00", "00", "00", "00", "00", "00", "00", "00", "00", "00", "B1", "B1", "B1", "B1", "B1", "B1", "B1", "B1", "B1", "B1", "B1", "B1", "B1", "B1", "B1", "B1", "B1", "B1", "B1", "B1", "B1", "B1", "B1", "B1", "B1", "B1", "B1", "B1", "B1", "B1", "B1", "B1", "B1", "B1", "B1", "B1", "B1", "B1", "B1", "B1", "B1", "00", "00", "00", "00", "00", "00", "00", "00", "00", "00", "00", "b1", "b1", "b1", "b1", "b1", "b1", "b1", "00", "00", "00", "00", "00", "00", "00", "00", "00", "b1", "00", "00", "00", "00", "00", "00", "00", "00", "00", "00", "00", "00", "00", "00", "00", "00", "00", "00", "00", "00", "00", "00", "00", "00"],
		["00", "00", "00", "00", "00", "00", "00", "00", "00", "00", "00", "00", "00", "00", "00", "00", "00", "00", "00", "00", "00", "00", "00", "00", "00", "00", "00", "00", "00", "00", "00", "00", "00", "00", "00", "00", "00", "00", "00", "00", "00", "00", "00", "00", "00", "00", "00", "00", "00", "00", "00", "00", "00", "00", "00", "00", "00", "00", "B1", "00", "00", "00", "B1", "00", "00", "00", "00", "00", "00", "00", "00", "00", "00", "00", "00", "00", "00", "00", "00", "00", "00", "00", "00", "00", "00", "00", "00", "00", "00", "00", "00", "00", "00", "00", "00", "00", "00", "00", "00", "00", "00", "00", "00", "00", "00", "S1", "00", "00", "00", "00", "00", "00", "00", "00", "B1", "B1", "B1", "B1", "B1", "B1", "B1", "B1", "B1", "B1", "B1", "B1", "B1", "B1", "00", "00", "00", "00", "00", "00", "00", "00", "00", "00", "00", "00", "00", "00", "00", "00", "00", "00", "00", "00", "00", "00", "00", "00", "00", "B1", "B1", "B1", "B1", "B1", "B1", "B1", "B1", "B1", "B1", "B1", "B1", "B1", "B1", "B1", "B1", "B1", "B1", "B1", "B1", "B1", "B1", "B1", "B1", "B1", "B1", "B1", "B1", "B1", "B1", "B1", "B1", "B1", "B1", "B1", "B1", "B1", "B1", "B1", "B1", "B1", "00", "00", "00", "00", "00", "00", "00", "00", "00", "00", "00", "00", "00", "00", "00", "00", "00", "00", "00", "b1", "b1", "b1", "b1", "b1", "00", "00", "00", "00", "00", "00", "00", "00", "00", "00", "00", "00", "00", "00", "00", "00", "00", "00", "00", "00", "00", "00", "00", "00", "00", "00", "00", "00"],
		["00", "00", "00", "00", "00", "00", "00", "00", "00", "00", "00", "00", "00", "00", "00", "00", "00", "00", "00", "00", "00", "S1", "00", "00", "00", "00", "00", "00", "00", "00", "00", "00", "00", "00", "00", "00", "s1", "S1", "00", "00", "00", "00", "00", "00", "00", "00", "00", "00", "00", "00", "00", "00", "S1", "S1", "B1", "s1", "s1", "s1", "B1", "s1", "s1", "s1", "B1", "00", "00", "00", "00", "00", "00", "00", "00", "00", "00", "00", "00", "00", "00", "00", "00", "00", "00", "00", "S1", "S1", "00", "00", "00", "00", "00", "B1", "B1", "B1", "B1", "B1", "B1", "B1", "B1", "s1", "s1", "s1", "B1", "B1", "B1", "B1", "B1", "B1", "B1", "B1", "B1", "B1", "B1", "s1", "s1", "s1", "B1", "B1", "B1", "B1", "B1", "B1", "B1", "B1", "B1", "B1", "B1", "B1", "B1", "B1", "s1", "s1", "s1", "s1", "s1", "s1", "s1", "s1", "s1", "s1", "s1", "s1", "s1", "s1", "s1", "s1", "s1", "s1", "s1", "s1", "s1", "s1", "s1", "s1", "s1", "B1", "B1", "B1", "B1", "B1", "B1", "B1", "B1", "B1", "B1", "B1", "B1", "B1", "B1", "B1", "B1", "B1", "B1", "B1", "B1", "B1", "B1", "B1", "B1", "B1", "B1", "B1", "B1", "B1", "B1", "B1", "B1", "B1", "B1", "B1", "B1", "B1", "B1", "B1", "B1", "B1", "s1", "s1", "s1", "s1", "s1", "s1", "s1", "s1", "s1", "s1", "s1", "s1", "s1", "s1", "s1", "s1", "s1", "s1", "s1", "s1", "s1", "s1", "s1", "s1", "s1", "s1", "s1", "s1", "s1", "s1", "s1", "s1", "s1", "s1", "s1", "s1", "s1", "s1", "s1", "s1", "s1", "s1", "s1", "s1", "s1", "s1", "s1", "s1", "s1", "s1", "s1", "s1"]
	]
}